111111111111111111111111111111111
111111111000000000110000000000001
11111111101100000111000000C000001
111111111001000000000000000000001
1111111110110000011100000000P0001
10000000C011000001110111111111111
111101111111110111000000100011111
111101111111110111010100100011111
110000001101010111000000100011111
1000C0000000000011000000000011111
10000000000000001101010010E011111
110000011101010111110111000011111
111101110111010101011110100011111
111111111111111111111111111111111