11111111111111111111111111
11111111C0000001100M000001
11111101100000111000000C01
11111111M00100000000000001
11111101C000001110000000P1
10000C01100000111011111111
111101111110111000M0010001
11110111111011101010010001
1000C000000001100000010001
1000000000M00C101010000E01
11111101101010101111010001
11111111111111111111111111